+-+-+-+-+-+-+-+-+-+-+
S   |   |           |
+-+ + + + +-+-+-+-+ +
|   | | | |     | | |
+ +-+ + + +-+-+ + + +
| |   |   |         |
+ + +-+-+-+ +-+ +-+ +
| | |   |   |   |   |
+ + + +-+ +-+ +-+-+-+
|   | |     | |     |
+-+-+ + +-+-+ +-+ + +
|     | |   |     | |
+ +-+-+ +-+ +-+-+-+-+
|         |         |
+-+ +-+ + +-+ +-+-+ +
|   |   |     |   | |
+ +-+-+-+-+-+-+ + + +
|     |   |     |   |
+-+-+ + + + +-+ +-+-+
|     | |   |       E
+-+-+-+-+-+-+-+-+-+-+